111111111111111111111
1P0000200000100000001
111011111110111011111
1C010000000C000010X01
101011111111110101111
10001000000000001X001
111011111101111011111
100000001000000000001
101111101111111101111
10X000001000000000X01
101110111101111011111
100010000000000010001
101011111111110101111
1C0100X0000C000010001
111011111110111011111
100X0000X0000100000E1
111111111111111111111