111111111
1P0001001
1X00C00E1
111111111